5 5 32
1 3 3 2 2
3 3 1 3 2
3 3 3 3 2
3 1 1 3 2
0 0 1 3 0